"filename", "language", "XML", "Java Properties", "Java", "HTML", "comment", "blank", "total"
"c:\KimJongHun\Workspace\11_for_sts3\river_dice\testgame\.settings\org.eclipse.wst.common.project.facet.core.xml", "XML", 8, 0, 0, 0, 0, 1, 9
"c:\KimJongHun\Workspace\11_for_sts3\river_dice\testgame\pom.xml", "XML", 192, 0, 0, 0, 25, 8, 225
"c:\KimJongHun\Workspace\11_for_sts3\river_dice\testgame\src\main\java\com\milite\battle\BattleContext.java", "Java", 0, 0, 381, 0, 1, 83, 465
"c:\KimJongHun\Workspace\11_for_sts3\river_dice\testgame\src\main\java\com\milite\battle\BattleLogEntry.java", "Java", 0, 0, 17, 0, 0, 4, 21
"c:\KimJongHun\Workspace\11_for_sts3\river_dice\testgame\src\main\java\com\milite\battle\BattleMonsterUnit.java", "Java", 0, 0, 111, 0, 3, 23, 137
"c:\KimJongHun\Workspace\11_for_sts3\river_dice\testgame\src\main\java\com\milite\battle\BattleSession.java", "Java", 0, 0, 393, 0, 18, 96, 507
"c:\KimJongHun\Workspace\11_for_sts3\river_dice\testgame\src\main\java\com\milite\battle\BattleUnit.java", "Java", 0, 0, 32, 0, 0, 13, 45
"c:\KimJongHun\Workspace\11_for_sts3\river_dice\testgame\src\main\java\com\milite\battle\abilities\BlindAbility.java", "Java", 0, 0, 53, 0, 4, 21, 78
"c:\KimJongHun\Workspace\11_for_sts3\river_dice\testgame\src\main\java\com\milite\battle\abilities\BloodSuckAbility.java", "Java", 0, 0, 38, 0, 0, 16, 54
"c:\KimJongHun\Workspace\11_for_sts3\river_dice\testgame\src\main\java\com\milite\battle\abilities\BraveBiteAbility.java", "Java", 0, 0, 41, 0, 0, 16, 57
"c:\KimJongHun\Workspace\11_for_sts3\river_dice\testgame\src\main\java\com\milite\battle\abilities\DoubleAttackAbility.java", "Java", 0, 0, 27, 0, 1, 15, 43
"c:\KimJongHun\Workspace\11_for_sts3\river_dice\testgame\src\main\java\com\milite\battle\abilities\FlameArmorAbility.java", "Java", 0, 0, 34, 0, 1, 15, 50
"c:\KimJongHun\Workspace\11_for_sts3\river_dice\testgame\src\main\java\com\milite\battle\abilities\FormChangeAbility.java", "Java", 0, 0, 77, 0, 2, 29, 108
"c:\KimJongHun\Workspace\11_for_sts3\river_dice\testgame\src\main\java\com\milite\battle\abilities\ImmunAbility.java", "Java", 0, 0, 41, 0, 0, 14, 55
"c:\KimJongHun\Workspace\11_for_sts3\river_dice\testgame\src\main\java\com\milite\battle\abilities\ModeSwitchAbility.java", "Java", 0, 0, 76, 0, 0, 29, 105
"c:\KimJongHun\Workspace\11_for_sts3\river_dice\testgame\src\main\java\com\milite\battle\abilities\RecoveryAbility.java", "Java", 0, 0, 36, 0, 0, 14, 50
"c:\KimJongHun\Workspace\11_for_sts3\river_dice\testgame\src\main\java\com\milite\battle\abilities\SpecialAbility.java", "Java", 0, 0, 12, 0, 12, 8, 32
"c:\KimJongHun\Workspace\11_for_sts3\river_dice\testgame\src\main\java\com\milite\battle\abilities\SpecialAbilityFactory.java", "Java", 0, 0, 23, 0, 0, 5, 28
"c:\KimJongHun\Workspace\11_for_sts3\river_dice\testgame\src\main\java\com\milite\battle\abilities\SummonAbility.java", "Java", 0, 0, 56, 0, 0, 21, 77
"c:\KimJongHun\Workspace\11_for_sts3\river_dice\testgame\src\main\java\com\milite\battle\abilities\SwiftAbility.java", "Java", 0, 0, 27, 0, 0, 15, 42
"c:\KimJongHun\Workspace\11_for_sts3\river_dice\testgame\src\main\java\com\milite\battle\abilities\ThreeChanceAbility.java", "Java", 0, 0, 50, 0, 0, 15, 65
"c:\KimJongHun\Workspace\11_for_sts3\river_dice\testgame\src\main\java\com\milite\battle\abilities\ThreeStackAbility.java", "Java", 0, 0, 50, 0, 0, 14, 64
"c:\KimJongHun\Workspace\11_for_sts3\river_dice\testgame\src\main\java\com\milite\battle\artifacts\BlackCoralArtifact.java", "Java", 0, 0, 45, 0, 0, 18, 63
"c:\KimJongHun\Workspace\11_for_sts3\river_dice\testgame\src\main\java\com\milite\battle\artifacts\BlueTridentArtifact.java", "Java", 0, 0, 48, 0, 0, 20, 68
"c:\KimJongHun\Workspace\11_for_sts3\river_dice\testgame\src\main\java\com\milite\battle\artifacts\BlurryLensArtifact.java", "Java", 0, 0, 38, 0, 0, 17, 55
"c:\KimJongHun\Workspace\11_for_sts3\river_dice\testgame\src\main\java\com\milite\battle\artifacts\BrokenBladeArtifact.java", "Java", 0, 0, 44, 0, 0, 17, 61
"c:\KimJongHun\Workspace\11_for_sts3\river_dice\testgame\src\main\java\com\milite\battle\artifacts\BurningLavaStoneArtifact.java", "Java", 0, 0, 48, 0, 0, 19, 67
"c:\KimJongHun\Workspace\11_for_sts3\river_dice\testgame\src\main\java\com\milite\battle\artifacts\DarkHammerArtifact.java", "Java", 0, 0, 45, 0, 0, 20, 65
"c:\KimJongHun\Workspace\11_for_sts3\river_dice\testgame\src\main\java\com\milite\battle\artifacts\DeepsPearlArtifact.java", "Java", 0, 0, 51, 0, 0, 19, 70
"c:\KimJongHun\Workspace\11_for_sts3\river_dice\testgame\src\main\java\com\milite\battle\artifacts\DruidBeltArtifact.java", "Java", 0, 0, 48, 0, 0, 20, 68
"c:\KimJongHun\Workspace\11_for_sts3\river_dice\testgame\src\main\java\com\milite\battle\artifacts\DryWoodArtifact.java", "Java", 0, 0, 41, 0, 0, 19, 60
"c:\KimJongHun\Workspace\11_for_sts3\river_dice\testgame\src\main\java\com\milite\battle\artifacts\ElementStoneArtifact.java", "Java", 0, 0, 48, 0, 0, 20, 68
"c:\KimJongHun\Workspace\11_for_sts3\river_dice\testgame\src\main\java\com\milite\battle\artifacts\FighterGuildMedalArtifact.java", "Java", 0, 0, 54, 0, 0, 21, 75
"c:\KimJongHun\Workspace\11_for_sts3\river_dice\testgame\src\main\java\com\milite\battle\artifacts\ForbiddenScrollArtifact.java", "Java", 0, 0, 57, 0, 0, 23, 80
"c:\KimJongHun\Workspace\11_for_sts3\river_dice\testgame\src\main\java\com\milite\battle\artifacts\GrayCloakArtifact.java", "Java", 0, 0, 38, 0, 0, 18, 56
"c:\KimJongHun\Workspace\11_for_sts3\river_dice\testgame\src\main\java\com\milite\battle\artifacts\MagicianAmuletArtifact.java", "Java", 0, 0, 48, 0, 0, 21, 69
"c:\KimJongHun\Workspace\11_for_sts3\river_dice\testgame\src\main\java\com\milite\battle\artifacts\OverloadCrystalArtifact.java", "Java", 0, 0, 57, 0, 0, 22, 79
"c:\KimJongHun\Workspace\11_for_sts3\river_dice\testgame\src\main\java\com\milite\battle\artifacts\PhoenixFeatherArtifact.java", "Java", 0, 0, 69, 0, 1, 28, 98
"c:\KimJongHun\Workspace\11_for_sts3\river_dice\testgame\src\main\java\com\milite\battle\artifacts\PlayerArtifact.java", "Java", 0, 0, 16, 0, 0, 11, 27
"c:\KimJongHun\Workspace\11_for_sts3\river_dice\testgame\src\main\java\com\milite\battle\artifacts\PlayerArtifactFactory.java", "Java", 0, 0, 30, 0, 0, 11, 41
"c:\KimJongHun\Workspace\11_for_sts3\river_dice\testgame\src\main\java\com\milite\battle\artifacts\PoisonNeedleArtifact.java", "Java", 0, 0, 48, 0, 0, 21, 69
"c:\KimJongHun\Workspace\11_for_sts3\river_dice\testgame\src\main\java\com\milite\battle\artifacts\SeaHeartArtifact.java", "Java", 0, 0, 45, 0, 0, 18, 63
"c:\KimJongHun\Workspace\11_for_sts3\river_dice\testgame\src\main\java\com\milite\battle\artifacts\ShadowDeviceArtifact.java", "Java", 0, 0, 41, 0, 0, 19, 60
"c:\KimJongHun\Workspace\11_for_sts3\river_dice\testgame\src\main\java\com\milite\battle\artifacts\SlipperyLeatherArtifact.java", "Java", 0, 0, 57, 0, 0, 22, 79
"c:\KimJongHun\Workspace\11_for_sts3\river_dice\testgame\src\main\java\com\milite\constants\BattleConstants.java", "Java", 0, 0, 208, 0, 18, 65, 291
"c:\KimJongHun\Workspace\11_for_sts3\river_dice\testgame\src\main\java\com\milite\controller\BattleController.java", "Java", 0, 0, 829, 0, 6, 180, 1015
"c:\KimJongHun\Workspace\11_for_sts3\river_dice\testgame\src\main\java\com\milite\controller\CampController.java", "Java", 0, 0, 49, 0, 5, 10, 64
"c:\KimJongHun\Workspace\11_for_sts3\river_dice\testgame\src\main\java\com\milite\controller\CampRestController.java", "Java", 0, 0, 128, 0, 6, 22, 156
"c:\KimJongHun\Workspace\11_for_sts3\river_dice\testgame\src\main\java\com\milite\controller\EventController.java", "Java", 0, 0, 170, 0, 22, 21, 213
"c:\KimJongHun\Workspace\11_for_sts3\river_dice\testgame\src\main\java\com\milite\controller\EventRestController.java", "Java", 0, 0, 161, 0, 29, 29, 219
"c:\KimJongHun\Workspace\11_for_sts3\river_dice\testgame\src\main\java\com\milite\controller\GameController.java", "Java", 0, 0, 15, 0, 0, 3, 18
"c:\KimJongHun\Workspace\11_for_sts3\river_dice\testgame\src\main\java\com\milite\controller\StartRestController.java", "Java", 0, 0, 69, 0, 5, 13, 87
"c:\KimJongHun\Workspace\11_for_sts3\river_dice\testgame\src\main\java\com\milite\dto\ActiveRewardDto.java", "Java", 0, 0, 87, 0, 0, 23, 110
"c:\KimJongHun\Workspace\11_for_sts3\river_dice\testgame\src\main\java\com\milite\dto\ArtifactDto.java", "Java", 0, 0, 15, 0, 0, 3, 18
"c:\KimJongHun\Workspace\11_for_sts3\river_dice\testgame\src\main\java\com\milite\dto\ArtifactEventDto.java", "Java", 0, 0, 8, 0, 0, 2, 10
"c:\KimJongHun\Workspace\11_for_sts3\river_dice\testgame\src\main\java\com\milite\dto\BattleResultDto.java", "Java", 0, 0, 15, 0, 0, 6, 21
"c:\KimJongHun\Workspace\11_for_sts3\river_dice\testgame\src\main\java\com\milite\dto\BossEventDto.java", "Java", 0, 0, 9, 0, 0, 2, 11
"c:\KimJongHun\Workspace\11_for_sts3\river_dice\testgame\src\main\java\com\milite\dto\CardEventDto.java", "Java", 0, 0, 9, 0, 0, 2, 11
"c:\KimJongHun\Workspace\11_for_sts3\river_dice\testgame\src\main\java\com\milite\dto\CharacterDto.java", "Java", 0, 0, 11, 0, 0, 3, 14
"c:\KimJongHun\Workspace\11_for_sts3\river_dice\testgame\src\main\java\com\milite\dto\MonsterDto.java", "Java", 0, 0, 19, 0, 0, 2, 21
"c:\KimJongHun\Workspace\11_for_sts3\river_dice\testgame\src\main\java\com\milite\dto\NormalEventDto.java", "Java", 0, 0, 15, 0, 0, 3, 18
"c:\KimJongHun\Workspace\11_for_sts3\river_dice\testgame\src\main\java\com\milite\dto\PlayerDto.java", "Java", 0, 0, 133, 0, 0, 32, 165
"c:\KimJongHun\Workspace\11_for_sts3\river_dice\testgame\src\main\java\com\milite\dto\RewardDto.java", "Java", 0, 0, 47, 0, 3, 10, 60
"c:\KimJongHun\Workspace\11_for_sts3\river_dice\testgame\src\main\java\com\milite\dto\RollEventDto.java", "Java", 0, 0, 18, 0, 0, 4, 22
"c:\KimJongHun\Workspace\11_for_sts3\river_dice\testgame\src\main\java\com\milite\dto\SelectChoiceDto.java", "Java", 0, 0, 17, 0, 0, 4, 21
"c:\KimJongHun\Workspace\11_for_sts3\river_dice\testgame\src\main\java\com\milite\dto\SelectEventDto.java", "Java", 0, 0, 8, 0, 0, 2, 10
"c:\KimJongHun\Workspace\11_for_sts3\river_dice\testgame\src\main\java\com\milite\dto\SkillDto.java", "Java", 0, 0, 21, 0, 1, 6, 28
"c:\KimJongHun\Workspace\11_for_sts3\river_dice\testgame\src\main\java\com\milite\dto\TrapEventDto.java", "Java", 0, 0, 14, 0, 0, 2, 16
"c:\KimJongHun\Workspace\11_for_sts3\river_dice\testgame\src\main\java\com\milite\dto\UserDto.java", "Java", 0, 0, 13, 0, 0, 2, 15
"c:\KimJongHun\Workspace\11_for_sts3\river_dice\testgame\src\main\java\com\milite\mapper\ArtifactMapper.java", "Java", 0, 0, 8, 0, 0, 6, 14
"c:\KimJongHun\Workspace\11_for_sts3\river_dice\testgame\src\main\java\com\milite\mapper\BattleConstantsMapper.java", "Java", 0, 0, 8, 0, 0, 6, 14
"c:\KimJongHun\Workspace\11_for_sts3\river_dice\testgame\src\main\java\com\milite\mapper\BattleMapper.java", "Java", 0, 0, 6, 0, 0, 3, 9
"c:\KimJongHun\Workspace\11_for_sts3\river_dice\testgame\src\main\java\com\milite\mapper\CharacterStatusMapper.java", "Java", 0, 0, 13, 0, 0, 9, 22
"c:\KimJongHun\Workspace\11_for_sts3\river_dice\testgame\src\main\java\com\milite\mapper\EventMapper.java", "Java", 0, 0, 41, 0, 9, 22, 72
"c:\KimJongHun\Workspace\11_for_sts3\river_dice\testgame\src\main\java\com\milite\mapper\MonsterMapper.java", "Java", 0, 0, 8, 0, 0, 3, 11
"c:\KimJongHun\Workspace\11_for_sts3\river_dice\testgame\src\main\java\com\milite\mapper\SkillMapper.java", "Java", 0, 0, 8, 0, 2, 5, 15
"c:\KimJongHun\Workspace\11_for_sts3\river_dice\testgame\src\main\java\com\milite\mapper\StartMapper.java", "Java", 0, 0, 13, 0, 4, 8, 25
"c:\KimJongHun\Workspace\11_for_sts3\river_dice\testgame\src\main\java\com\milite\mapper\UserMapper.java", "Java", 0, 0, 7, 0, 1, 4, 12
"c:\KimJongHun\Workspace\11_for_sts3\river_dice\testgame\src\main\java\com\milite\service\BattleConstantsService.java", "Java", 0, 0, 64, 0, 1, 18, 83
"c:\KimJongHun\Workspace\11_for_sts3\river_dice\testgame\src\main\java\com\milite\service\BattleService.java", "Java", 0, 0, 12, 0, 0, 8, 20
"c:\KimJongHun\Workspace\11_for_sts3\river_dice\testgame\src\main\java\com\milite\service\BattleServiceImpl.java", "Java", 0, 0, 554, 0, 17, 148, 719
"c:\KimJongHun\Workspace\11_for_sts3\river_dice\testgame\src\main\java\com\milite\service\CampService.java", "Java", 0, 0, 6, 0, 6, 3, 15
"c:\KimJongHun\Workspace\11_for_sts3\river_dice\testgame\src\main\java\com\milite\service\CampServiceImpl.java", "Java", 0, 0, 52, 0, 12, 19, 83
"c:\KimJongHun\Workspace\11_for_sts3\river_dice\testgame\src\main\java\com\milite\service\EventService.java", "Java", 0, 0, 34, 0, 28, 23, 85
"c:\KimJongHun\Workspace\11_for_sts3\river_dice\testgame\src\main\java\com\milite\service\EventServiceImpl.java", "Java", 0, 0, 204, 0, 29, 26, 259
"c:\KimJongHun\Workspace\11_for_sts3\river_dice\testgame\src\main\java\com\milite\service\RewardService.java", "Java", 0, 0, 17, 0, 0, 15, 32
"c:\KimJongHun\Workspace\11_for_sts3\river_dice\testgame\src\main\java\com\milite\service\RewardServiceImpl.java", "Java", 0, 0, 411, 0, 0, 88, 499
"c:\KimJongHun\Workspace\11_for_sts3\river_dice\testgame\src\main\java\com\milite\service\SkillService.java", "Java", 0, 0, 20, 0, 8, 16, 44
"c:\KimJongHun\Workspace\11_for_sts3\river_dice\testgame\src\main\java\com\milite\service\SkillServiceImpl.java", "Java", 0, 0, 301, 0, 9, 67, 377
"c:\KimJongHun\Workspace\11_for_sts3\river_dice\testgame\src\main\java\com\milite\service\StartService.java", "Java", 0, 0, 17, 0, 5, 8, 30
"c:\KimJongHun\Workspace\11_for_sts3\river_dice\testgame\src\main\java\com\milite\service\StartServiceImpl.java", "Java", 0, 0, 56, 0, 4, 10, 70
"c:\KimJongHun\Workspace\11_for_sts3\river_dice\testgame\src\main\java\com\milite\test\BraveBiteDirectTest.java", "Java", 0, 0, 77, 0, 9, 19, 105
"c:\KimJongHun\Workspace\11_for_sts3\river_dice\testgame\src\main\java\com\milite\test\SkillChange.java", "Java", 0, 0, 0, 0, 63, 1, 64
"c:\KimJongHun\Workspace\11_for_sts3\river_dice\testgame\src\main\java\com\milite\testgame\HomeController.java", "Java", 0, 0, 23, 0, 6, 11, 40
"c:\KimJongHun\Workspace\11_for_sts3\river_dice\testgame\src\main\java\com\milite\util\CommonUtil.java", "Java", 0, 0, 27, 0, 0, 7, 34
"c:\KimJongHun\Workspace\11_for_sts3\river_dice\testgame\src\main\java\com\milite\util\KoreanUtil.java", "Java", 0, 0, 17, 0, 0, 3, 20
"c:\KimJongHun\Workspace\11_for_sts3\river_dice\testgame\src\main\java\com\milite\util\RewardUtil.java", "Java", 0, 0, 22, 0, 0, 8, 30
"c:\KimJongHun\Workspace\11_for_sts3\river_dice\testgame\src\main\java\com\milite\util\StringUtil.java", "Java", 0, 0, 68, 0, 0, 23, 91
"c:\KimJongHun\Workspace\11_for_sts3\river_dice\testgame\src\main\resources\application.properties", "Java Properties", 0, 3, 0, 0, 0, 0, 3
"c:\KimJongHun\Workspace\11_for_sts3\river_dice\testgame\src\main\resources\com\milite\mapper\ArtifactMapper.xml", "XML", 46, 0, 0, 0, 3, 4, 53
"c:\KimJongHun\Workspace\11_for_sts3\river_dice\testgame\src\main\resources\com\milite\mapper\BattleConstantsMapper.xml", "XML", 18, 0, 0, 0, 0, 5, 23
"c:\KimJongHun\Workspace\11_for_sts3\river_dice\testgame\src\main\resources\com\milite\mapper\CharacterStatusMapper.xml", "XML", 110, 0, 0, 0, 4, 12, 126
"c:\KimJongHun\Workspace\11_for_sts3\river_dice\testgame\src\main\resources\com\milite\mapper\EventMapper.xml", "XML", 199, 0, 0, 0, 12, 20, 231
"c:\KimJongHun\Workspace\11_for_sts3\river_dice\testgame\src\main\resources\com\milite\mapper\MonsterMapper.xml", "XML", 66, 0, 0, 0, 0, 3, 69
"c:\KimJongHun\Workspace\11_for_sts3\river_dice\testgame\src\main\resources\com\milite\mapper\RewardMapper.xml", "XML", 1, 0, 0, 0, 0, 0, 1
"c:\KimJongHun\Workspace\11_for_sts3\river_dice\testgame\src\main\resources\com\milite\mapper\SkillMapper.xml", "XML", 32, 0, 0, 0, 0, 2, 34
"c:\KimJongHun\Workspace\11_for_sts3\river_dice\testgame\src\main\resources\com\milite\mapper\StartMapper.xml", "XML", 28, 0, 0, 0, 4, 6, 38
"c:\KimJongHun\Workspace\11_for_sts3\river_dice\testgame\src\main\resources\com\milite\mapper\UserMapper.xml", "XML", 17, 0, 0, 0, 2, 3, 22
"c:\KimJongHun\Workspace\11_for_sts3\river_dice\testgame\src\main\resources\log4j.xml", "XML", 43, 0, 0, 0, 6, 8, 57
"c:\KimJongHun\Workspace\11_for_sts3\river_dice\testgame\src\main\resources\log4jdbc.log4j2.properties", "Java Properties", 0, 1, 0, 0, 0, 0, 1
"c:\KimJongHun\Workspace\11_for_sts3\river_dice\testgame\src\main\webapp\WEB-INF\spring\appServlet\servlet-context.xml", "XML", 27, 0, 0, 0, 8, 9, 44
"c:\KimJongHun\Workspace\11_for_sts3\river_dice\testgame\src\main\webapp\WEB-INF\spring\root-context.xml", "XML", 36, 0, 0, 0, 19, 13, 68
"c:\KimJongHun\Workspace\11_for_sts3\river_dice\testgame\src\main\webapp\WEB-INF\views\battle_start.jsp", "HTML", 0, 0, 0, 22, 1, 0, 23
"c:\KimJongHun\Workspace\11_for_sts3\river_dice\testgame\src\main\webapp\WEB-INF\views\camp.jsp", "HTML", 0, 0, 0, 36, 2, 3, 41
"c:\KimJongHun\Workspace\11_for_sts3\river_dice\testgame\src\main\webapp\WEB-INF\views\event\artifact.jsp", "HTML", 0, 0, 0, 20, 1, 2, 23
"c:\KimJongHun\Workspace\11_for_sts3\river_dice\testgame\src\main\webapp\WEB-INF\views\event\artifact_result.jsp", "HTML", 0, 0, 0, 15, 0, 3, 18
"c:\KimJongHun\Workspace\11_for_sts3\river_dice\testgame\src\main\webapp\WEB-INF\views\event\boss.jsp", "HTML", 0, 0, 0, 10, 0, 1, 11
"c:\KimJongHun\Workspace\11_for_sts3\river_dice\testgame\src\main\webapp\WEB-INF\views\event\boss_result.jsp", "HTML", 0, 0, 0, 11, 0, 2, 13
"c:\KimJongHun\Workspace\11_for_sts3\river_dice\testgame\src\main\webapp\WEB-INF\views\event\card.jsp", "HTML", 0, 0, 0, 20, 0, 2, 22
"c:\KimJongHun\Workspace\11_for_sts3\river_dice\testgame\src\main\webapp\WEB-INF\views\event\card_result.jsp", "HTML", 0, 0, 0, 15, 0, 3, 18
"c:\KimJongHun\Workspace\11_for_sts3\river_dice\testgame\src\main\webapp\WEB-INF\views\event\normal.jsp", "HTML", 0, 0, 0, 11, 3, 2, 16
"c:\KimJongHun\Workspace\11_for_sts3\river_dice\testgame\src\main\webapp\WEB-INF\views\event\normal_result.jsp", "HTML", 0, 0, 0, 12, 0, 2, 14
"c:\KimJongHun\Workspace\11_for_sts3\river_dice\testgame\src\main\webapp\WEB-INF\views\event\roll.jsp", "HTML", 0, 0, 0, 11, 0, 2, 13
"c:\KimJongHun\Workspace\11_for_sts3\river_dice\testgame\src\main\webapp\WEB-INF\views\event\roll_result.jsp", "HTML", 0, 0, 0, 12, 0, 2, 14
"c:\KimJongHun\Workspace\11_for_sts3\river_dice\testgame\src\main\webapp\WEB-INF\views\event\select.jsp", "HTML", 0, 0, 0, 13, 0, 2, 15
"c:\KimJongHun\Workspace\11_for_sts3\river_dice\testgame\src\main\webapp\WEB-INF\views\event\select_result.jsp", "HTML", 0, 0, 0, 12, 0, 2, 14
"c:\KimJongHun\Workspace\11_for_sts3\river_dice\testgame\src\main\webapp\WEB-INF\views\event\trap.jsp", "HTML", 0, 0, 0, 10, 1, 1, 12
"c:\KimJongHun\Workspace\11_for_sts3\river_dice\testgame\src\main\webapp\WEB-INF\views\event\trap_result.jsp", "HTML", 0, 0, 0, 12, 0, 2, 14
"c:\KimJongHun\Workspace\11_for_sts3\river_dice\testgame\src\main\webapp\WEB-INF\views\home.jsp", "HTML", 0, 0, 0, 17, 1, 4, 22
"c:\KimJongHun\Workspace\11_for_sts3\river_dice\testgame\src\main\webapp\WEB-INF\web.xml", "XML", 25, 0, 0, 0, 3, 6, 34
"c:\KimJongHun\Workspace\11_for_sts3\river_dice\testgame\src\main\webapp\resources\application.properties", "Java Properties", 0, 3, 0, 0, 0, 0, 3
"c:\KimJongHun\Workspace\11_for_sts3\river_dice\testgame\src\main\webapp\resources\log4j.properties", "Java Properties", 0, 11, 0, 0, 3, 2, 16
"c:\KimJongHun\Workspace\11_for_sts3\river_dice\testgame\src\main\webapp\resources\log4j.xml", "XML", 43, 0, 0, 0, 6, 8, 57
"c:\KimJongHun\Workspace\11_for_sts3\river_dice\testgame\src\main\webapp\resources\log4jdbc.log4j2.properties", "Java Properties", 0, 1, 0, 0, 0, 0, 1
"c:\KimJongHun\Workspace\11_for_sts3\river_dice\testgame\src\test\resources\log4j.xml", "XML", 29, 0, 0, 0, 4, 9, 42
"c:\KimJongHun\Workspace\11_for_sts3\river_dice\testgame\target\classes\application.properties", "Java Properties", 0, 3, 0, 0, 0, 0, 3
"c:\KimJongHun\Workspace\11_for_sts3\river_dice\testgame\target\classes\com\milite\battle\BattleContext.class", "Java", 0, 0, 123, 0, 0, 0, 123
"c:\KimJongHun\Workspace\11_for_sts3\river_dice\testgame\target\classes\com\milite\battle\BattleLogEntry.class", "Java", 0, 0, 44, 0, 0, 0, 44
"c:\KimJongHun\Workspace\11_for_sts3\river_dice\testgame\target\classes\com\milite\battle\BattleMonsterUnit.class", "Java", 0, 0, 116, 0, 0, 3, 119
"c:\KimJongHun\Workspace\11_for_sts3\river_dice\testgame\target\classes\com\milite\battle\BattleSession$BattleState.class", "Java", 0, 0, 21, 0, 8, 0, 29
"c:\KimJongHun\Workspace\11_for_sts3\river_dice\testgame\target\classes\com\milite\battle\BattleSession.class", "Java", 0, 0, 256, 0, 0, 1, 257
"c:\KimJongHun\Workspace\11_for_sts3\river_dice\testgame\target\classes\com\milite\battle\BattleUnit.class", "Java", 0, 0, 19, 0, 0, 0, 19
"c:\KimJongHun\Workspace\11_for_sts3\river_dice\testgame\target\classes\com\milite\battle\DelayedAction.class", "Java", 0, 0, 2, 0, 0, 0, 2
"c:\KimJongHun\Workspace\11_for_sts3\river_dice\testgame\target\classes\com\milite\battle\ReflectDamageAction.class", "Java", 0, 0, 17, 0, 0, 0, 17
"c:\KimJongHun\Workspace\11_for_sts3\river_dice\testgame\target\classes\com\milite\battle\StatusEffectAction.class", "Java", 0, 0, 29, 0, 0, 0, 29
"c:\KimJongHun\Workspace\11_for_sts3\river_dice\testgame\target\classes\com\milite\battle\SummonAction.class", "Java", 0, 0, 12, 0, 0, 0, 12
"c:\KimJongHun\Workspace\11_for_sts3\river_dice\testgame\target\classes\com\milite\battle\abilities\BlindAbility.class", "Java", 0, 0, 28, 0, 0, 0, 28
"c:\KimJongHun\Workspace\11_for_sts3\river_dice\testgame\target\classes\com\milite\battle\abilities\BloodSuckAbility.class", "Java", 0, 0, 22, 0, 0, 0, 22
"c:\KimJongHun\Workspace\11_for_sts3\river_dice\testgame\target\classes\com\milite\battle\abilities\BraveBiteAbility.class", "Java", 0, 0, 23, 0, 0, 0, 23
"c:\KimJongHun\Workspace\11_for_sts3\river_dice\testgame\target\classes\com\milite\battle\abilities\DoubleAttackAbility.class", "Java", 0, 0, 12, 0, 0, 0, 12
"c:\KimJongHun\Workspace\11_for_sts3\river_dice\testgame\target\classes\com\milite\battle\abilities\FlameArmorAbility.class", "Java", 0, 0, 21, 0, 0, 0, 21
"c:\KimJongHun\Workspace\11_for_sts3\river_dice\testgame\target\classes\com\milite\battle\abilities\FormChangeAbility.class", "Java", 0, 0, 42, 0, 0, 0, 42
"c:\KimJongHun\Workspace\11_for_sts3\river_dice\testgame\target\classes\com\milite\battle\abilities\ImmunAbility.class", "Java", 0, 0, 23, 0, 0, 0, 23
"c:\KimJongHun\Workspace\11_for_sts3\river_dice\testgame\target\classes\com\milite\battle\abilities\ModeSwitchAbility.class", "Java", 0, 0, 41, 0, 0, 0, 41
"c:\KimJongHun\Workspace\11_for_sts3\river_dice\testgame\target\classes\com\milite\battle\abilities\RecoveryAbility.class", "Java", 0, 0, 19, 0, 0, 0, 19
"c:\KimJongHun\Workspace\11_for_sts3\river_dice\testgame\target\classes\com\milite\battle\abilities\SpecialAbility.class", "Java", 0, 0, 4, 0, 0, 0, 4
"c:\KimJongHun\Workspace\11_for_sts3\river_dice\testgame\target\classes\com\milite\battle\abilities\SpecialAbilityFactory.class", "Java", 0, 0, 32, 0, 0, 0, 32
"c:\KimJongHun\Workspace\11_for_sts3\river_dice\testgame\target\classes\com\milite\battle\abilities\SummonAbility.class", "Java", 0, 0, 32, 0, 0, 0, 32
"c:\KimJongHun\Workspace\11_for_sts3\river_dice\testgame\target\classes\com\milite\battle\abilities\SwiftAbility.class", "Java", 0, 0, 13, 0, 0, 0, 13
"c:\KimJongHun\Workspace\11_for_sts3\river_dice\testgame\target\classes\com\milite\battle\abilities\ThreeChanceAbility.class", "Java", 0, 0, 30, 0, 0, 0, 30
"c:\KimJongHun\Workspace\11_for_sts3\river_dice\testgame\target\classes\com\milite\battle\abilities\ThreeStackAbility.class", "Java", 0, 0, 31, 0, 0, 0, 31
"c:\KimJongHun\Workspace\11_for_sts3\river_dice\testgame\target\classes\com\milite\battle\artifacts\BlackCoralArtifact.class", "Java", 0, 0, 22, 0, 0, 0, 22
"c:\KimJongHun\Workspace\11_for_sts3\river_dice\testgame\target\classes\com\milite\battle\artifacts\BlueTridentArtifact.class", "Java", 0, 0, 16, 0, 0, 0, 16
"c:\KimJongHun\Workspace\11_for_sts3\river_dice\testgame\target\classes\com\milite\battle\artifacts\BlurryLensArtifact.class", "Java", 0, 0, 12, 0, 0, 0, 12
"c:\KimJongHun\Workspace\11_for_sts3\river_dice\testgame\target\classes\com\milite\battle\artifacts\BrokenBladeArtifact.class", "Java", 0, 0, 18, 0, 0, 0, 18
"c:\KimJongHun\Workspace\11_for_sts3\river_dice\testgame\target\classes\com\milite\battle\artifacts\BurningLavaStoneArtifact.class", "Java", 0, 0, 16, 0, 0, 0, 16
"c:\KimJongHun\Workspace\11_for_sts3\river_dice\testgame\target\classes\com\milite\battle\artifacts\DarkHammerArtifact.class", "Java", 0, 0, 16, 0, 0, 0, 16
"c:\KimJongHun\Workspace\11_for_sts3\river_dice\testgame\target\classes\com\milite\battle\artifacts\DeepsPearlArtifact.class", "Java", 0, 0, 25, 0, 0, 0, 25
"c:\KimJongHun\Workspace\11_for_sts3\river_dice\testgame\target\classes\com\milite\battle\artifacts\DruidBeltArtifact.class", "Java", 0, 0, 16, 0, 0, 0, 16
"c:\KimJongHun\Workspace\11_for_sts3\river_dice\testgame\target\classes\com\milite\battle\artifacts\DryWoodArtifact.class", "Java", 0, 0, 11, 0, 0, 0, 11
"c:\KimJongHun\Workspace\11_for_sts3\river_dice\testgame\target\classes\com\milite\battle\artifacts\ElementStoneArtifact.class", "Java", 0, 0, 18, 0, 0, 0, 18
"c:\KimJongHun\Workspace\11_for_sts3\river_dice\testgame\target\classes\com\milite\battle\artifacts\FighterGuildMedalArtifact.class", "Java", 0, 0, 19, 0, 0, 0, 19
"c:\KimJongHun\Workspace\11_for_sts3\river_dice\testgame\target\classes\com\milite\battle\artifacts\ForbiddenScrollArtifact.class", "Java", 0, 0, 24, 0, 0, 0, 24
"c:\KimJongHun\Workspace\11_for_sts3\river_dice\testgame\target\classes\com\milite\battle\artifacts\GrayCloakArtifact.class", "Java", 0, 0, 13, 0, 0, 0, 13
"c:\KimJongHun\Workspace\11_for_sts3\river_dice\testgame\target\classes\com\milite\battle\artifacts\MagicianAmuletArtifact.class", "Java", 0, 0, 18, 0, 0, 0, 18
"c:\KimJongHun\Workspace\11_for_sts3\river_dice\testgame\target\classes\com\milite\battle\artifacts\OverloadCrystalArtifact.class", "Java", 0, 0, 25, 0, 0, 0, 25
"c:\KimJongHun\Workspace\11_for_sts3\river_dice\testgame\target\classes\com\milite\battle\artifacts\PhoenixFeatherArtifact.class", "Java", 0, 0, 29, 0, 0, 0, 29
"c:\KimJongHun\Workspace\11_for_sts3\river_dice\testgame\target\classes\com\milite\battle\artifacts\PlayerArtifact.class", "Java", 0, 0, 4, 0, 0, 0, 4
"c:\KimJongHun\Workspace\11_for_sts3\river_dice\testgame\target\classes\com\milite\battle\artifacts\PlayerArtifactFactory.class", "Java", 0, 0, 37, 0, 0, 0, 37
"c:\KimJongHun\Workspace\11_for_sts3\river_dice\testgame\target\classes\com\milite\battle\artifacts\PoisonNeedleArtifact.class", "Java", 0, 0, 15, 0, 0, 0, 15
"c:\KimJongHun\Workspace\11_for_sts3\river_dice\testgame\target\classes\com\milite\battle\artifacts\SeaHeartArtifact.class", "Java", 0, 0, 23, 0, 0, 0, 23
"c:\KimJongHun\Workspace\11_for_sts3\river_dice\testgame\target\classes\com\milite\battle\artifacts\ShadowDeviceArtifact.class", "Java", 0, 0, 13, 0, 0, 0, 13
"c:\KimJongHun\Workspace\11_for_sts3\river_dice\testgame\target\classes\com\milite\battle\artifacts\SlipperyLeatherArtifact.class", "Java", 0, 0, 25, 0, 0, 0, 25
"c:\KimJongHun\Workspace\11_for_sts3\river_dice\testgame\target\classes\com\milite\constants\BattleConstants.class", "Java", 0, 0, 29, 0, 0, 0, 29
"c:\KimJongHun\Workspace\11_for_sts3\river_dice\testgame\target\classes\com\milite\controller\BattleController.class", "Java", 0, 0, 234, 0, 0, 3, 237
"c:\KimJongHun\Workspace\11_for_sts3\river_dice\testgame\target\classes\com\milite\controller\CampController.class", "Java", 0, 0, 26, 0, 0, 0, 26
"c:\KimJongHun\Workspace\11_for_sts3\river_dice\testgame\target\classes\com\milite\controller\CampRestController.class", "Java", 0, 0, 45, 0, 0, 0, 45
"c:\KimJongHun\Workspace\11_for_sts3\river_dice\testgame\target\classes\com\milite\controller\EventController.class", "Java", 0, 0, 57, 0, 0, 0, 57
"c:\KimJongHun\Workspace\11_for_sts3\river_dice\testgame\target\classes\com\milite\controller\EventRestController$ApiResponse.class", "Java", 0, 0, 37, 0, 0, 0, 37
"c:\KimJongHun\Workspace\11_for_sts3\river_dice\testgame\target\classes\com\milite\controller\EventRestController.class", "Java", 0, 0, 66, 0, 0, 0, 66
"c:\KimJongHun\Workspace\11_for_sts3\river_dice\testgame\target\classes\com\milite\controller\GameController.class", "Java", 0, 0, 9, 0, 0, 0, 9
"c:\KimJongHun\Workspace\11_for_sts3\river_dice\testgame\target\classes\com\milite\controller\StartRestController$ApiResponse.class", "Java", 0, 0, 36, 0, 0, 0, 36
"c:\KimJongHun\Workspace\11_for_sts3\river_dice\testgame\target\classes\com\milite\controller\StartRestController$StateDto.class", "Java", 0, 0, 30, 0, 0, 0, 30
"c:\KimJongHun\Workspace\11_for_sts3\river_dice\testgame\target\classes\com\milite\controller\StartRestController.class", "Java", 0, 0, 28, 0, 0, 0, 28
"c:\KimJongHun\Workspace\11_for_sts3\river_dice\testgame\target\classes\com\milite\dto\ActiveRewardDto.class", "Java", 0, 0, 74, 0, 0, 0, 74
"c:\KimJongHun\Workspace\11_for_sts3\river_dice\testgame\target\classes\com\milite\dto\ArtifactDto.class", "Java", 0, 0, 37, 0, 0, 0, 37
"c:\KimJongHun\Workspace\11_for_sts3\river_dice\testgame\target\classes\com\milite\dto\ArtifactEventDto.class", "Java", 0, 0, 33, 0, 0, 0, 33
"c:\KimJongHun\Workspace\11_for_sts3\river_dice\testgame\target\classes\com\milite\dto\BattleResultDto.class", "Java", 0, 0, 36, 0, 0, 0, 36
"c:\KimJongHun\Workspace\11_for_sts3\river_dice\testgame\target\classes\com\milite\dto\BossEventDto.class", "Java", 0, 0, 35, 0, 2, 0, 37
"c:\KimJongHun\Workspace\11_for_sts3\river_dice\testgame\target\classes\com\milite\dto\CardEventDto.class", "Java", 0, 0, 35, 0, 2, 0, 37
"c:\KimJongHun\Workspace\11_for_sts3\river_dice\testgame\target\classes\com\milite\dto\CharacterDto.class", "Java", 0, 0, 32, 0, 0, 0, 32
"c:\KimJongHun\Workspace\11_for_sts3\river_dice\testgame\target\classes\com\milite\dto\MonsterDto.class", "Java", 0, 0, 52, 0, 6, 0, 58
"c:\KimJongHun\Workspace\11_for_sts3\river_dice\testgame\target\classes\com\milite\dto\NormalEventDto.class", "Java", 0, 0, 44, 0, 0, 0, 44
"c:\KimJongHun\Workspace\11_for_sts3\river_dice\testgame\target\classes\com\milite\dto\PlayerDto.class", "Java", 0, 0, 106, 0, 0, 0, 106
"c:\KimJongHun\Workspace\11_for_sts3\river_dice\testgame\target\classes\com\milite\dto\RewardDto.class", "Java", 0, 0, 54, 0, 0, 0, 54
"c:\KimJongHun\Workspace\11_for_sts3\river_dice\testgame\target\classes\com\milite\dto\RollEventDto.class", "Java", 0, 0, 47, 0, 0, 0, 47
"c:\KimJongHun\Workspace\11_for_sts3\river_dice\testgame\target\classes\com\milite\dto\SelectChoiceDto.class", "Java", 0, 0, 40, 0, 0, 0, 40
"c:\KimJongHun\Workspace\11_for_sts3\river_dice\testgame\target\classes\com\milite\dto\SelectEventDto.class", "Java", 0, 0, 33, 0, 0, 0, 33
"c:\KimJongHun\Workspace\11_for_sts3\river_dice\testgame\target\classes\com\milite\dto\SkillDto.class", "Java", 0, 0, 96, 0, 0, 0, 96
"c:\KimJongHun\Workspace\11_for_sts3\river_dice\testgame\target\classes\com\milite\dto\TrapEventDto.class", "Java", 0, 0, 37, 0, 0, 0, 37
"c:\KimJongHun\Workspace\11_for_sts3\river_dice\testgame\target\classes\com\milite\dto\UserDto.class", "Java", 0, 0, 36, 0, 0, 0, 36
"c:\KimJongHun\Workspace\11_for_sts3\river_dice\testgame\target\classes\com\milite\mapper\ArtifactMapper.class", "Java", 0, 0, 4, 0, 0, 0, 4
"c:\KimJongHun\Workspace\11_for_sts3\river_dice\testgame\target\classes\com\milite\mapper\ArtifactMapper.xml", "XML", 46, 0, 0, 0, 3, 4, 53
"c:\KimJongHun\Workspace\11_for_sts3\river_dice\testgame\target\classes\com\milite\mapper\BattleConstantsMapper.class", "Java", 0, 0, 4, 0, 0, 0, 4
"c:\KimJongHun\Workspace\11_for_sts3\river_dice\testgame\target\classes\com\milite\mapper\BattleConstantsMapper.xml", "XML", 18, 0, 0, 0, 0, 5, 23
"c:\KimJongHun\Workspace\11_for_sts3\river_dice\testgame\target\classes\com\milite\mapper\BattleMapper.class", "Java", 0, 0, 2, 0, 0, 1, 3
"c:\KimJongHun\Workspace\11_for_sts3\river_dice\testgame\target\classes\com\milite\mapper\CharacterStatusMapper.class", "Java", 0, 0, 6, 0, 0, 0, 6
"c:\KimJongHun\Workspace\11_for_sts3\river_dice\testgame\target\classes\com\milite\mapper\CharacterStatusMapper.xml", "XML", 110, 0, 0, 0, 4, 12, 126
"c:\KimJongHun\Workspace\11_for_sts3\river_dice\testgame\target\classes\com\milite\mapper\EventMapper.class", "Java", 0, 0, 14, 0, 0, 0, 14
"c:\KimJongHun\Workspace\11_for_sts3\river_dice\testgame\target\classes\com\milite\mapper\EventMapper.xml", "XML", 199, 0, 0, 0, 12, 20, 231
"c:\KimJongHun\Workspace\11_for_sts3\river_dice\testgame\target\classes\com\milite\mapper\MonsterMapper.class", "Java", 0, 0, 5, 0, 0, 0, 5
"c:\KimJongHun\Workspace\11_for_sts3\river_dice\testgame\target\classes\com\milite\mapper\MonsterMapper.xml", "XML", 66, 0, 0, 0, 0, 3, 69
"c:\KimJongHun\Workspace\11_for_sts3\river_dice\testgame\target\classes\com\milite\mapper\RewardMapper.xml", "XML", 1, 0, 0, 0, 0, 0, 1
"c:\KimJongHun\Workspace\11_for_sts3\river_dice\testgame\target\classes\com\milite\mapper\SkillMapper.class", "Java", 0, 0, 4, 0, 0, 0, 4
"c:\KimJongHun\Workspace\11_for_sts3\river_dice\testgame\target\classes\com\milite\mapper\SkillMapper.xml", "XML", 32, 0, 0, 0, 0, 2, 34
"c:\KimJongHun\Workspace\11_for_sts3\river_dice\testgame\target\classes\com\milite\mapper\StartMapper.class", "Java", 0, 0, 4, 0, 0, 0, 4
"c:\KimJongHun\Workspace\11_for_sts3\river_dice\testgame\target\classes\com\milite\mapper\StartMapper.xml", "XML", 28, 0, 0, 0, 4, 6, 38
"c:\KimJongHun\Workspace\11_for_sts3\river_dice\testgame\target\classes\com\milite\mapper\UserMapper.class", "Java", 0, 0, 5, 0, 0, 0, 5
"c:\KimJongHun\Workspace\11_for_sts3\river_dice\testgame\target\classes\com\milite\mapper\UserMapper.xml", "XML", 17, 0, 0, 0, 2, 3, 22
"c:\KimJongHun\Workspace\11_for_sts3\river_dice\testgame\target\classes\com\milite\service\BattleConstantsService.class", "Java", 0, 0, 34, 0, 0, 1, 35
"c:\KimJongHun\Workspace\11_for_sts3\river_dice\testgame\target\classes\com\milite\service\BattleService.class", "Java", 0, 0, 4, 0, 0, 0, 4
"c:\KimJongHun\Workspace\11_for_sts3\river_dice\testgame\target\classes\com\milite\service\BattleServiceImpl.class", "Java", 0, 0, 276, 0, 30, 3, 309
"c:\KimJongHun\Workspace\11_for_sts3\river_dice\testgame\target\classes\com\milite\service\CampService.class", "Java", 0, 0, 3, 0, 0, 0, 3
"c:\KimJongHun\Workspace\11_for_sts3\river_dice\testgame\target\classes\com\milite\service\CampServiceImpl.class", "Java", 0, 0, 39, 0, 0, 0, 39
"c:\KimJongHun\Workspace\11_for_sts3\river_dice\testgame\target\classes\com\milite\service\EventService.class", "Java", 0, 0, 7, 0, 0, 0, 7
"c:\KimJongHun\Workspace\11_for_sts3\river_dice\testgame\target\classes\com\milite\service\EventServiceImpl.class", "Java", 0, 0, 70, 0, 0, 0, 70
"c:\KimJongHun\Workspace\11_for_sts3\river_dice\testgame\target\classes\com\milite\service\RewardService.class", "Java", 0, 0, 6, 0, 0, 0, 6
"c:\KimJongHun\Workspace\11_for_sts3\river_dice\testgame\target\classes\com\milite\service\RewardServiceImpl.class", "Java", 0, 0, 146, 0, 0, 0, 146
"c:\KimJongHun\Workspace\11_for_sts3\river_dice\testgame\target\classes\com\milite\service\SkillService.class", "Java", 0, 0, 14, 0, 0, 0, 14
"c:\KimJongHun\Workspace\11_for_sts3\river_dice\testgame\target\classes\com\milite\service\SkillServiceImpl.class", "Java", 0, 0, 102, 0, 0, 0, 102
"c:\KimJongHun\Workspace\11_for_sts3\river_dice\testgame\target\classes\com\milite\service\StartService$StartState.class", "Java", 0, 0, 8, 0, 0, 0, 8
"c:\KimJongHun\Workspace\11_for_sts3\river_dice\testgame\target\classes\com\milite\service\StartService.class", "Java", 0, 0, 7, 0, 0, 0, 7
"c:\KimJongHun\Workspace\11_for_sts3\river_dice\testgame\target\classes\com\milite\service\StartServiceImpl.class", "Java", 0, 0, 31, 0, 2, 0, 33
"c:\KimJongHun\Workspace\11_for_sts3\river_dice\testgame\target\classes\com\milite\test\BraveBiteDirectTest.class", "Java", 0, 0, 81, 0, 0, 0, 81
"c:\KimJongHun\Workspace\11_for_sts3\river_dice\testgame\target\classes\com\milite\testgame\HomeController.class", "Java", 0, 0, 12, 0, 0, 0, 12
"c:\KimJongHun\Workspace\11_for_sts3\river_dice\testgame\target\classes\com\milite\util\CommonUtil.class", "Java", 0, 0, 24, 0, 0, 0, 24
"c:\KimJongHun\Workspace\11_for_sts3\river_dice\testgame\target\classes\com\milite\util\KoreanUtil.class", "Java", 0, 0, 16, 0, 0, 0, 16
"c:\KimJongHun\Workspace\11_for_sts3\river_dice\testgame\target\classes\com\milite\util\RewardUtil.class", "Java", 0, 0, 23, 0, 0, 0, 23
"c:\KimJongHun\Workspace\11_for_sts3\river_dice\testgame\target\classes\com\milite\util\StringUtil.class", "Java", 0, 0, 64, 0, 0, 0, 64
"c:\KimJongHun\Workspace\11_for_sts3\river_dice\testgame\target\classes\log4j.xml", "XML", 43, 0, 0, 0, 6, 8, 57
"c:\KimJongHun\Workspace\11_for_sts3\river_dice\testgame\target\classes\log4jdbc.log4j2.properties", "Java Properties", 0, 1, 0, 0, 0, 0, 1
"c:\KimJongHun\Workspace\11_for_sts3\river_dice\testgame\target\m2e-wtp\web-resources\META-INF\maven\com.milite\testgame\pom.properties", "Java Properties", 0, 5, 0, 0, 2, 1, 8
"c:\KimJongHun\Workspace\11_for_sts3\river_dice\testgame\target\m2e-wtp\web-resources\META-INF\maven\com.milite\testgame\pom.xml", "XML", 192, 0, 0, 0, 25, 8, 225
"c:\KimJongHun\Workspace\11_for_sts3\river_dice\testgame\target\test-classes\log4j.xml", "XML", 29, 0, 0, 0, 4, 9, 42
"Total", "-", 1701, 28, 10639, 259, 571, 2175, 15373